1 1 1 1 1 1 1 1 1 1 1 1 1 1 1 1 1 1 1 1 1 1 1 1 1 1 1 1 1 1 1 1
1 4 6 4 6 4 6 4 6 4 6 4 6 4 6 4 6 4 6 4 6 4 6 4 6 4 6 4 6 4 6 1
1 6 4 1 4 6 4 6 4 6 4 6 4 6 4 6 4 6 4 6 4 6 4 6 4 6 4 6 4 6 4 1
1 6 6 1 1 6 4 6 4 6 4 6 4 6 4 6 4 6 4 6 4 6 4 6 4 6 4 6 4 6 4 1
1 4 6 1 6 4 1 4 6 4 6 4 6 4 6 4 1 4 6 4 6 4 6 4 6 4 6 4 6 4 6 1
1 6 4 6 4 6 1 1 4 6 4 6 4 6 4 1 1 1 4 6 4 6 4 1 4 6 4 6 4 6 4 1
1 4 6 4 6 1 1 4 6 4 6 4 6 4 6 4 1 4 6 4 1 1 1 1 6 4 6 4 6 4 6 1
1 6 4 6 4 6 4 6 4 6 4 6 4 6 4 6 4 6 4 6 4 6 4 1 4 6 4 6 4 6 4 1
1 4 6 4 6 4 6 4 6 4 6 4 6 4 6 4 6 4 6 4 6 4 6 4 6 4 6 4 6 4 6 1
1 6 4 6 4 6 4 6 4 6 4 6 1 6 4 6 4 6 4 6 4 6 4 6 4 6 4 6 4 6 4 1
1 4 6 4 6 4 6 4 6 4 6 1 6 1 6 4 6 4 6 4 6 4 6 4 6 4 6 4 6 4 6 1
1 6 4 6 4 6 4 6 4 6 4 6 1 6 4 6 4 6 4 6 4 6 4 6 4 6 4 6 4 6 4 1
1 4 6 4 6 4 6 4 6 4 6 4 6 4 6 4 6 4 6 4 6 4 6 4 6 4 6 4 6 4 6 1
1 6 4 6 4 6 4 6 4 6 4 6 4 6 4 6 4 6 4 6 4 6 4 6 4 6 4 6 4 6 4 1
1 4 6 4 6 4 6 4 6 4 6 4 6 4 6 4 6 4 6 4 6 4 6 4 6 4 6 4 6 4 6 1
1 1 1 1 1 1 1 1 1 1 1 1 1 1 1 1 1 1 1 1 1 1 1 1 1 1 1 1 1 1 1 1